{
  "a": ["ā", "á", "ǎ", "à"],
  "e": ["ē", "é", "ě", "è"],
  "o": ["ō", "ó", "ǒ", "ò"],
  "i": ["ī", "í", "ǐ", "ì"],
  "u": ["ū", "ú", "ǔ", "ù"],
  "v": ["ü", "ǘ", "ǚ", "ǜ"],
  "ü": ["ü", "ǘ", "ǚ", "ǜ"],
  "n": ["n", "ń", "ň"]
}
